wwwwwwwwwwwwwwwww
w000000000000000w
w00w0w0w0w0w0w00w
w000b00000000000w
w0wbw0000000w0w0w
w0000ifkbbbb0000w
w0w000w0w0w000w0w
w0000bb0bb000000w
w0w0w00b0000w0w0w
w00ss00b00000000w
w00w0w0w0w0w0w00w
w000000000000000w
wwwwwwwwwwwwwwwww
