wwwwwwwwwwwwwwwww
w000000000000000w
w0w0w0w0w0w0w0w0w
w000b00000000000w
w0wbw0w0w0w0w0w0w
w0000if000000000w
w0w0w0w0w0w0w0w0w
w0000bb0bb000000w
w0w0w0wbw0w0w0w0w
w00ss00b00000000w
w0w0w0w0w0w0w0w0w
w0000000000k0000w
wwwwwwwwwwwwwwwww