000000000000000
0w0w0w0w0w0w0w0
000000000000000
0w0w0w0w0w0w0w0
000000000000000
0w0w0w0w0w0w0w0
000000000000000
0w0w0w0w0w0w0w0
000000100000000
0w0w0w0w0w0w0w0
000000000000000