0bbbbbbbbbbbbb0
0wwwbwbwbwbwbw0
00b000000000000
000b0w0w0w0w0w0
00b000000000000
0wbw0wbw0w0w0w0
00b00bwb00b0000
0w0w0w0w0w0w0w0
0b0bw00b00b0000
0wbw0w0w0wbw0w0
000000000000000