wwwwwwwwwwwwwwwww
w0000000bbbb0000w
w0w0w0w0w0w0w0w0w
w000b00000000000w
w0wbw0w0w0w0w0w0w
w00000000bbb0000w
w0w0w0w0w0w0w0w0w
w0000bb0bb000000w
w0w0w0wbw0w0w0w0w
w0000bbbb0000000w
w0w0w0w0w0w0w0w0w
w000000000000000w
wwwwwwwwwwwwwwwww