wwwwwwwwwwwwwwwww
w0000000b0000000w
w0000000w0000000w
w0w0w0w0i0w0w0w0w
w0000000w0000000w
w000000bbb000000w
wbwbwswbwbwswfwbw
w000000bbb000000w
w0000000w0000000w
w0w0w0w0k0w0w0w0w
w0000000w0000000w
w0000000b0000000w
wwwwwwwwwwwwwwwww