wwwwwwwwwwwwwwwww
w0000000b0000000w
w0000000w0000000w
w000b000b0000000w
w0000000w0000000w
w0000000b0000000w
wbwbwbwbwbwbwbwbw
w0000bb0bb000000w
w0000000w0000000w
w0000000b0000000w
w0000000w0000000w
w0000000b0000000w
wwwwwwwwwwwwwwwww