wwwwwwwwwwwwwwwww
w000000000000000w
w00000bbsbb00000w
w00000b000b00000w
w00000b000b00000w
w00000sbbbb00000w
w0w0w0w0w0w0w0w0w
w0bbkbb000bfbbb0w
w0b000b000b000b0w
w0b000b000b000b0w
w0bibbb000bbbbf0w
w000000000000000w
wwwwwwwwwwwwwwwww