wwwwwwwwwwwwwwwww
w000000000000000w
w0w0w0w0w0w0w0w0w
w000b0000000bbb0w
w0wbw0w0w0w0w0w0w
wbbbbbb000000000w
w0w0w0w0w0w0w0w0w
w0000bb0bb000000w
w0w0w0wbw0w0w0w0w
w000000b00000000w
w0w0w0w0w0w0w0w0w
w0000000bbbb0000w
wwwwwwwwwwwwwwwww