1
#################
#               #
# % %*%*% %*%*% #
#          **** #
#*%*% %*%*%*%*%*#
#               #
#*%*%*%*%*% %*%*#
#  **           #
#*% %*% %*%*%*%*#
#               #
# % %*% % % % %*#
#       *****   #
#################
