1
#################
#               #
#*#*#*#*#*#*#*#*#
#               #
#*#*#*#*#*#*#*#*#
#               #
#*#*#*#*#*#*#*#*#
#               #
#*#*#*#*#*#*#*#*#
#               #
#*#*#*#*#*#*#*#*#
#               #
#################
