2
#################
#               #
# % %*%*% %*%*% #
#               #
#*%*% %*%*%*%*%*#
#   ******      #
#*%*%*%*%*% %*%*#
#  **           #
#*% %*% %*%*%*%*#
#       **      #
# % %*% % % % %*#
#       *****   #
#################